....................
...G............X...
...--..G.......--...
...AG.--.......AG...
...--..........--...
...G.....CG....GB...
...--....--....--...
....G...........G...
...--........G.--...
...G........--.G....
...--..........--...
....G..........BG...
...--..........--...
.1.....D......D.....
####################
