........................................................................................................................
........................................................................................................................
........................................................................................................................
........................................................................................................................
........................................................................................................................
........................................................................................................................
........................................................................................................................
........................................................................................................................
........................................................................................................................
........................................................................................................................
........1...........................................................................................................X...
------------------------------------------------------------------------------------------------------------------------
........................................................................................................................
........................................................................................................................
........................................................................................................................